1111111111111111111111
10000000000000000C0111
10001111110000P0000111
1001000000011100000011
1001011E10010100000011
1001000000010100000011
1001000000010100000111
1001001110011000C00001
1001001010010000000011
10011100100100000C0011
10CC000000CCCCC0000111
1111111111111111111111