1111111111
1EC11111P1
1111111111