1111111111111111111111111
1E0C000000000000000001111
111110000000CCC111C100111
111100000101010000100P111
1000C00000000CCCC00000011
1111111111111111111111111