1111111111111111111111
10000000000000000C0111
10001111111000P0000111
1001000000010000000111
1001011E10010000000111
1001000000011100000011
1001000000010100000111
100100111001010C000011
1001001010011100000001
10011100100100000C0011
10CCCCCCCCCCCCC0000111
1111111111111111111111