
11111111111
1000000ECP1
11111111111