1111111111
1CEP111U11
1111111111